F 0,055,055
NO ./assets/North.xpm 
SO ./assets/South.xpm 
WE ./assets/West.xpm 
EA ./assets/East.xpm 
C 0,,055



111111111111111111111111111111111111111111111111111111111111111111111111111111111111111111111111111111111111111111111111111111111111111111111111111111
1000S0000000000000000000000000000000000000000000000000000000000000000000000000000000000000000000000000000000000000000000000000000000000000000000003051
111111111111111111111111111111111111111111111111111111111111111111111111111111111111111111111111111111111111111111111111111111111111111111111111111111


